"Vaccinedato","geo","Antal påbegyndt vacc. personer","Antal borgere","Påbegyndtvacc. (%)","Kumuleret antal påbegyndt vacc."
2020-12-17,Nationalt,1,5847731,0.00,1
2020-12-19,Nationalt,1,5847731,0.00,2
2020-12-21,Nationalt,1,5847731,0.00,3
2020-12-22,Nationalt,1,5847731,0.00,4
2020-12-23,Nationalt,3,5847731,0.00,7
2020-12-24,Nationalt,1,5847731,0.00,8
2020-12-26,Nationalt,1,5847731,0.00,9
2020-12-27,Nationalt,6295,5847731,0.11,6304
2020-12-28,Nationalt,2003,5847731,0.14,8307
2020-12-29,Nationalt,8722,5847731,0.29,17029
2020-12-30,Nationalt,11163,5847731,0.48,28192
2020-12-31,Nationalt,5978,5847731,0.58,34170
2021-01-01,Nationalt,2274,5847731,0.62,36444
2021-01-02,Nationalt,8587,5847731,0.77,45031
2021-01-03,Nationalt,5781,5847731,0.87,50812
2021-01-04,Nationalt,2397,5847731,0.91,53209
2021-01-05,Nationalt,13146,5847731,1.13,66355
2021-01-06,Nationalt,19186,5847731,1.46,85541
2021-01-07,Nationalt,16994,5847731,1.75,102535
2021-01-08,Nationalt,8228,5847731,1.89,110763
2021-01-09,Nationalt,1877,5847731,1.93,112640
2021-01-10,Nationalt,816,5847731,1.94,113456
2021-01-11,Nationalt,659,5847731,1.95,114115
2021-01-12,Nationalt,465,5847731,1.96,114580
2021-01-13,Nationalt,12565,5847731,2.17,127145
2021-01-14,Nationalt,17632,5847731,2.48,144777
2021-01-15,Nationalt,14943,5847731,2.73,159720
2021-01-16,Nationalt,4522,5847731,2.81,164242
2021-01-17,Nationalt,2448,5847731,2.85,166690
2021-01-18,Nationalt,3783,5847731,2.92,170473
2021-01-19,Nationalt,2435,5847731,2.96,172908
2021-01-20,Nationalt,1480,5847731,2.98,174388
2021-01-21,Nationalt,1495,5847731,3.01,175883
2021-01-22,Nationalt,655,5847731,3.02,176538
2021-01-23,Nationalt,726,5847731,3.03,177264
2021-01-24,Nationalt,592,5847731,3.04,177856
2021-01-25,Nationalt,274,5847731,3.05,178130
2021-01-26,Nationalt,209,5847731,3.05,178339
2021-01-27,Nationalt,201,5847731,3.05,178540
2021-01-28,Nationalt,217,5847731,3.06,178757
2021-01-29,Nationalt,1086,5847731,3.08,179843
2021-01-30,Nationalt,1182,5847731,3.10,181025
2021-01-31,Nationalt,1189,5847731,3.12,182214
2021-02-01,Nationalt,747,5847731,3.13,182961
2021-02-02,Nationalt,1996,5847731,3.16,184957
2021-02-03,Nationalt,1510,5847731,3.19,186467
2021-02-04,Nationalt,1402,5847731,3.21,187869
2021-02-05,Nationalt,1563,5847731,3.24,189432
2021-02-06,Nationalt,1004,5847731,3.26,190436
2021-02-07,Nationalt,1873,5847731,3.29,192309
2021-02-08,Nationalt,2510,5847731,3.33,194819
2021-02-09,Nationalt,3516,5847731,3.39,198335
2021-02-10,Nationalt,3263,5847731,3.45,201598
2021-02-11,Nationalt,5677,5847731,3.54,207275
2021-02-12,Nationalt,12062,5847731,3.75,219337
2021-02-13,Nationalt,6526,5847731,3.86,225863
2021-02-14,Nationalt,6203,5847731,3.97,232066
2021-02-15,Nationalt,13755,5847731,4.20,245821
2021-02-16,Nationalt,13183,5847731,4.43,259004
2021-02-17,Nationalt,10420,5847731,4.61,269424
2021-02-18,Nationalt,11447,5847731,4.80,280871
2021-02-19,Nationalt,13839,5847731,5.04,294710
2021-02-20,Nationalt,10434,5847731,5.22,305144
2021-02-21,Nationalt,10739,5847731,5.40,315883
2021-02-22,Nationalt,13466,5847731,5.63,329349
2021-02-23,Nationalt,14342,5847731,5.88,343691
2021-02-24,Nationalt,13667,5847731,6.11,357358
2021-02-25,Nationalt,14507,5847731,6.36,371865
2021-02-26,Nationalt,35961,5847731,6.97,407826
2021-02-27,Nationalt,6636,5847731,7.09,414462
2021-02-28,Nationalt,10942,5847731,7.27,425404
2021-03-01,Nationalt,19695,5847731,7.61,445099
2021-03-02,Nationalt,16687,5847731,7.90,461786
2021-03-03,Nationalt,12976,5847731,8.12,474762
2021-03-04,Nationalt,17423,5847731,8.42,492185
2021-03-05,Nationalt,16580,5847731,8.70,508765
2021-03-06,Nationalt,14604,5847731,8.95,523369
2021-03-07,Nationalt,12016,5847731,9.16,535385
2021-03-08,Nationalt,9579,5847731,9.32,544964
2021-03-09,Nationalt,10901,5847731,9.51,555865
2021-03-10,Nationalt,12056,5847731,9.71,567921
2021-03-11,Nationalt,4560,5847731,9.79,572481
2021-03-12,Nationalt,3353,5847731,9.85,575834
2021-03-13,Nationalt,4521,5847731,9.92,580355
2021-03-14,Nationalt,1232,5847731,9.95,581587
2021-03-15,Nationalt,2820,5847731,9.99,584407
2021-03-16,Nationalt,6812,5847731,10.1,591219
2021-03-17,Nationalt,10754,5847731,10.3,601973
2021-03-18,Nationalt,14683,5847731,10.5,616656
2021-03-19,Nationalt,7850,5847731,10.7,624506
2021-03-20,Nationalt,2960,5847731,10.7,627466
2021-03-21,Nationalt,4976,5847731,10.8,632442
2021-03-22,Nationalt,4102,5847731,10.9,636544
2021-03-23,Nationalt,6134,5847731,11.0,642678
2021-03-24,Nationalt,9884,5847731,11.2,652562
2021-03-25,Nationalt,7755,5847731,11.3,660317
2021-03-26,Nationalt,6173,5847731,11.4,666490
2021-03-27,Nationalt,9993,5847731,11.6,676483
2021-03-28,Nationalt,10806,5847731,11.8,687289
2021-03-29,Nationalt,18015,5847731,12.1,705304
2021-03-30,Nationalt,21696,5847731,12.4,727000
2021-03-31,Nationalt,13116,5847731,12.7,740116
2021-04-01,Nationalt,4204,5847731,12.7,744320
2021-04-02,Nationalt,4901,5847731,12.8,749221
2021-04-03,Nationalt,12136,5847731,13.0,761357
2021-04-04,Nationalt,11699,5847731,13.2,773056
2021-04-05,Nationalt,12329,5847731,13.4,785385
2021-04-06,Nationalt,16032,5847731,13.7,801417
2021-04-07,Nationalt,16649,5847731,14.0,818066
2021-04-08,Nationalt,13749,5847731,14.2,831815
2021-04-09,Nationalt,16502,5847731,14.5,848317
2021-04-10,Nationalt,16780,5847731,14.8,865097
2021-04-11,Nationalt,14900,5847731,15.0,879997
2021-04-12,Nationalt,94161,5847731,16.7,974158
2021-04-13,Nationalt,18536,5847731,17.0,992694
2021-04-14,Nationalt,11436,5847731,17.2,1004130
2021-04-15,Nationalt,15317,5847731,17.4,1019447
2021-04-16,Nationalt,17438,5847731,17.7,1036885
2021-04-17,Nationalt,18825,5847731,18.1,1055710
2021-04-18,Nationalt,14502,5847731,18.3,1070212
2021-04-19,Nationalt,24815,5847731,18.7,1095027
2021-04-20,Nationalt,22035,5847731,19.1,1117062
2021-04-21,Nationalt,22507,5847731,19.5,1139569
2021-04-22,Nationalt,28225,5847731,20.0,1167794
2021-04-23,Nationalt,22182,5847731,20.3,1189976
2021-04-24,Nationalt,14917,5847731,20.6,1204893
2021-04-25,Nationalt,15210,5847731,20.9,1220103
2021-04-26,Nationalt,31512,5847731,21.4,1251615
2021-04-27,Nationalt,26593,5847731,21.9,1278208
2021-04-28,Nationalt,24143,5847731,22.3,1302351
2021-04-29,Nationalt,25934,5847731,22.7,1328285
2021-04-30,Nationalt,13429,5847731,22.9,1341714
2021-05-01,Nationalt,7293,5847731,23.1,1349007
2021-05-02,Nationalt,16661,5847731,23.4,1365668
2021-05-03,Nationalt,20448,5847731,23.7,1386116
2021-05-04,Nationalt,27636,5847731,24.2,1413752
2021-05-05,Nationalt,26811,5847731,24.6,1440563
2021-05-06,Nationalt,21522,5847731,25.0,1462085
2021-05-07,Nationalt,16478,5847731,25.3,1478563
2021-05-08,Nationalt,9431,5847731,25.4,1487994
2021-05-09,Nationalt,15905,5847731,25.7,1503899
2021-05-10,Nationalt,26543,5847731,26.2,1530442
2021-05-11,Nationalt,29672,5847731,26.7,1560114
2021-05-12,Nationalt,26148,5847731,27.1,1586262
2021-05-13,Nationalt,19650,5847731,27.5,1605912
2021-05-14,Nationalt,20516,5847731,27.8,1626428
2021-05-15,Nationalt,15390,5847731,28.1,1641818
2021-05-16,Nationalt,19957,5847731,28.4,1661775
2021-05-17,Nationalt,31014,5847731,28.9,1692789
2021-05-18,Nationalt,29518,5847731,29.5,1722307
2021-05-19,Nationalt,31711,5847731,30.0,1754018
2021-05-20,Nationalt,32414,5847731,30.5,1786432
2021-05-21,Nationalt,35259,5847731,31.2,1821691
2021-05-22,Nationalt,25895,5847731,31.6,1847586
2021-05-23,Nationalt,22545,5847731,32.0,1870131
2021-05-24,Nationalt,23382,5847731,32.4,1893513
2021-05-25,Nationalt,43430,5847731,33.1,1936943
2021-05-26,Nationalt,47397,5847731,33.9,1984340
2021-05-27,Nationalt,49291,5847731,34.8,2033631
2021-05-28,Nationalt,41013,5847731,35.5,2074644
2021-05-29,Nationalt,29809,5847731,36.0,2104453
2021-05-30,Nationalt,25807,5847731,36.4,2130260
2021-05-31,Nationalt,36102,5847731,37.0,2166362
2021-06-01,Nationalt,39679,5847731,37.7,2206041
2021-06-02,Nationalt,42572,5847731,38.5,2248613
2021-06-03,Nationalt,36203,5847731,39.1,2284816
2021-06-04,Nationalt,41399,5847731,39.8,2326215
2021-06-05,Nationalt,34988,5847731,40.4,2361203
2021-06-06,Nationalt,29961,5847731,40.9,2391164
2021-06-07,Nationalt,53545,5847731,41.8,2444709
2021-06-08,Nationalt,53423,5847731,42.7,2498132
2021-06-09,Nationalt,52786,5847731,43.6,2550918
